4 4 4 4 4 4 4 4 4 4 4 4 4 4 4 4 4 4 4 4 4 4 4 4
4 0 0 0 0 0 0 0 0 0 0 0 0 0 0 0 0 0 0 0 0 0 0 4
4 0 1 0 0 0 0 0 0 0 0 0 0 0 0 0 0 0 0 0 0 0 0 4
4 0 2 0 0 0 0 0 0 0 0 0 0 0 0 0 0 0 0 0 0 0 0 4
4 0 3 0 0 0 0 0 0 0 0 0 0 0 0 0 0 0 0 0 0 0 0 4
4 0 4 0 0 0 0 5 5 5 5 5 5 5 5 5 3 3 0 3 3 3 3 3
4 0 5 0 0 0 0 5 0 5 0 5 0 5 0 5 3 0 0 0 3 3 3 3
4 0 6 0 0 0 0 5 0 0 0 0 0 0 0 5 3 0 0 0 0 0 0 3
4 0 7 0 0 0 0 0 0 0 0 0 0 0 0 0 0 0 0 0 3 3 3 3
4 0 0 0 0 0 0 5 0 0 0 0 0 0 0 5 3 0 0 0 0 0 0 3
4 0 0 0 0 0 0 5 0 0 0 0 0 0 0 5 3 0 0 0 3 3 3 3
4 0 0 0 0 0 0 5 5 5 5 0 5 5 5 5 3 3 3 3 3 3 3 3
1 1 1 1 1 1 1 1 1 1 1 0 1 1 1 1 1 1 1 1 1 1 1 1
1 0 0 0 0 0 0 0 0 0 0 0 0 0 0 0 0 0 0 0 0 0 0 1
1 1 1 1 1 1 0 1 1 1 1 0 1 1 1 1 1 1 1 1 1 1 1 1
4 4 4 4 4 4 0 4 4 4 1 0 1 2 2 2 2 2 2 2 2 2 2 2
4 0 0 0 0 0 0 0 0 4 1 0 1 2 0 0 0 0 0 2 0 0 0 2
4 0 0 0 0 0 0 0 0 0 0 0 1 2 0 0 0 0 0 2 0 0 0 2
4 0 0 0 0 0 0 0 0 4 1 0 1 2 0 0 0 0 0 2 2 0 2 2
4 0 1 0 1 0 0 0 0 4 1 0 0 0 0 0 6 0 0 0 0 0 0 2
4 0 0 5 0 0 0 0 0 4 1 0 1 2 0 0 0 0 0 2 2 0 2 2
4 0 1 0 1 0 0 0 0 4 1 0 1 2 0 0 0 0 0 2 0 0 0 2
4 0 0 0 0 0 0 0 0 4 1 0 1 2 0 0 0 0 0 2 0 0 0 2
4 4 4 4 4 4 4 4 4 4 1 1 1 2 2 2 2 2 2 2 2 2 2 2
